12 7 2 2 9 2 2 6 0 13 2 6 0 12 13 0 7 2 2 2 2 6 0 12 0 7 13 1 
0 1 12 0 1 12 0 1 0 12 0 1 12 0 1 0 1 0 0 13 0 10 2 6 12 1 0 1 
12 13 0 12 1 0 12 5 2 6 12 1 0 0 1 12 1 12 7 4 0 1 0 1 0 1 12 1
0 0 0 0 1 0 0 0 0 1 0 10 2 2 4 0 1 0 1 0 0 1 12 5 2 11 0 1 
7 2 6 12 10 2 2 13 0 10 2 11 0 0 0 12 1 12 10 2 2 4 0 0 12 1 12 1 
1 0 1 0 1 12 0 1 12 1 0 5 2 6 0 0 1 0 1 12 0 12 0 7 2 4 0 1 
1 12 1 0 1 0 12 1 0 1 12 0 0 10 2 13 4 12 1 0 12 7 2 4 0 12 0 1 
1 0 5 2 4 12 0 1 12 1 0 7 2 4 0 1 0 0 1 12 0 1 0 12 0 0 12 1 
1 12 0 0 0 0 12 1 0 1 12 1 0 12 0 10 2 2 4 0 7 8 2 2 2 2 2 11 
5 2 2 2 2 6 0 1 0 1 0 1 12 0 12 1 0 12 0 12 1 0 12 0 12 0 0 1 
0 0 12 0 0 10 2 3 2 8 2 3 2 2 2 8 2 6 12 0 13 0 7 2 9 2 2 13 
12 7 2 6 0 1 0 1 0 12 0 13 12 0 12 0 12 1 0 12 1 0 1 0 1 0 12 0 
0 1 0 5 2 4 0 1 0 0 0 12 0 12 0 12 0 5 2 2 8 2 4 0 1 0 0 0  
12 1 0 12 12 12 0 10 2 6 13 0 12 0 12 0 12 0 0 12 0 12 0 0 5 9 2 6 
12 10 2 2 9 2 2 11 0 5 2 6 0 12 13 0 7 2 2 2 2 6 0 12 0 1 13 1 
0 1 12 0 1 12 0 1 0 12 0 1 12 0 1 0 1 0 0 13 0 10 2 6 12 1 0 1 
12 13 0 12 1 0 12 5 2 6 12 1 0 0 1 12 1 12 7 4 0 1 0 1 0 1 12 1
0 0 0 0 1 0 0 0 0 1 0 10 2 2 4 0 1 0 1 0 0 1 12 5 2 11 0 1 
7 2 6 12 10 2 2 13 0 10 2 11 0 0 0 12 1 12 10 2 2 4 0 0 12 1 12 1 
1 0 1 0 1 12 0 1 12 1 0 5 2 6 0 0 1 0 1 12 0 12 0 7 2 4 0 1 
1 12 1 0 1 0 12 1 0 1 12 0 0 10 2 13 4 12 1 0 12 7 2 4 0 12 0 1 
1 0 5 2 4 12 0 1 12 1 0 7 2 4 0 1 0 0 1 12 0 1 0 12 0 0 12 1 
1 12 0 0 0 0 12 1 0 1 12 1 0 12 0 10 2 2 4 0 7 8 2 2 2 2 2 11 
5 2 2 2 2 6 0 1 0 1 0 1 12 0 12 1 0 12 0 12 1 0 12 0 12 0 0 1 
0 0 12 0 0 10 2 3 2 8 2 3 2 2 2 8 2 6 12 0 13 0 7 2 9 2 2 13 
12 7 2 6 0 1 0 1 0 12 0 13 12 0 12 0 12 1 0 12 1 0 1 0 1 0 12 0 
0 1 0 5 2 4 0 1 0 0 0 12 0 12 0 12 0 5 2 2 8 2 4 0 1 0 0 0  
12 1 0 12 12 12 0 5 2 2 13 0 12 0 12 0 12 0 0 12 0 12 0 0 5 2 13 0 